NO ./textures/north.xpm
SO ./textures/south.xpm
WE ./textures/west.xpm
EA ./textures/east.xpm
F 220,100,0
C 0,100,200

11111
1N001
1X001
11111
