F 0,255,0

EA ./textures/east.xpm

C 255,255,255

NO ./textures/north.xpm

SO ./textures/south.xpm

WE ./textures/west.xpm

111111111
100000001
1000S0001
100000001
111111111
