NO ./textures/north.xpm
SO ./textures/south.xpm
WE ./textures/west.xpm
EA ./textures/east.xpm
F 0,0,0
C 255,255,255

    1111111
    1000001
11111000001
1000000N001
11111000001
    1000001
    1111111
