NO ./assets/wall_01.xpm
SO ./assets/wall_02.xpm
WE ./assets/wall_03.xpm
EA ./assets/wall_04.xpm
F 100,100,100
C 50,50,50

1111111
1000001
100W001
1000001
1111111
