NO    ./textures/north.xpm
SO    ./textures/south.xpm
WE    ./textures/west.xpm
EA    ./textures/east.xpm
F   100,   100,100
C   200,200,   200

11111
1N001
10001
11111
